XXXXXXXXXXXXXXXXXXXXXXXXXXXXXXXXXXXXXXXX
X                  ww                  X
X                  RR                  X
X                                      X
X            XXXXXXXXXXXXXX            X
X                                      X
X    RR                          RR    X
X                                      X
XXXXXXXXXXXXXXXX        XXXXXXXXXXXXXXXX
X                                      X
X                               X  R   X
X                               X      X
X            XXXXXXXXXXXXXX     XXXXXXXX
X            XXXXXXXXXXXXXX     XXXXXXXX