xxxxxxxxxxxxxxxxxxxxxxxxxxxxxxxxxxxxxxxx
xxxxxxxxx                              x
xxxxxxxxx                              x
x                                      x
x                  rr                  x
x                 m  m                 x
x                  mm           x      x
x                              x       x
x                             x        x
x                            x         x
x           xxxxxxx  xxxxxxxx          x
x                                      x
x                                      x
x   x                       xx         x
x   x                       xx       xxx
x   x             x  x                 x
x   x            xx  xx                x
x   x           x x  x x               x
x   x         xx  x  x  xx             x
x   xxxxx   xxxxxxx  xxxxxx   xxxxx    x
