xxxxxxxxxxxxxxxx
x              x
x     w  w   R x
x     m  m     x
x              x
x              x
x              x
x       R      x