XXXXXXXXXXXXXXXXXXXXXXXXXXXXXXXXXXXXX
X                 X                 X 
X                 X                 X
X                                   X
X               w w w               X
X               m   m               X
X                 m                 X
X                                   X
X                 X                 X
X                 X                 X
X                 X                 X
X    R            X            R    X
X                 X                 X
X                 X                 X
X                                   X
X                 R                 X
