xxxxxxxxxxxxxxxxxxxxxxxxxxxxxxxxxxxxx
x                 x                 x 
x                 x                 x
x                                   x
x               w w w               x
x               m   m               x
x                 m                 x
x                                   x
x                 x                 x
x                 x                 x
x                 x                 x
x    R            x            R    x
x                 x                 x
x                 x                 x
x                                   x
x                 R                 x