xxxxxxx
x     x
xw    x
x     x
x     x
x     x
x     x
x     x
x     x
x  R  x