xxxxxxx
x     x
xw   mx
x     x
x     x
x     x
x     x
x     x
x     x
x  R  x