xxxxxxxxxxxxxxxxxxxxxxxxxxxxxxxxxxxxxxxxx
xxxxxxxxx                               x
xxxxxxxxx                               x
x                                       x
x                   w                   x
x                 w   w                 x
x                   m            x      x
x                               x       x
x                              x        x
x                             x         x
x           xxxxxxx   xxxxxxxx          x
x                                       x
x                                       x
x   x                        xx         x
x   x     R                  xx       xxx
x   x             x   x                 x
x   x            xx   xx                x
x   x           x x   x x               x
x   x         xx  x   x  xx             x
x   xxxxx   xxxxxxx   xxxxxx   xxxxx    x
x                   R                   x
