XXXXXXXXXXXXXXXXXXXXXXXXXXXXXXXXXXXXXXXXXXXXXXXXXXXXXXXXXX
X                           W                            X
X                                                        X
X     R     X                                 X    R     X
X           X                                 X          X
XXXXXXXXXXXXX                                 XXXXXXXXXXXX
X                                                        X
X                                                        X
X                                                        X
X                          R R                           X
X                           R                            X