xxxxxxx
x     x
x w m x
x     x
x     x
xxx xxx
x     x
x     x
x     x
x  R  x
