XXXXXXXXXXXXXXXXXXX
X       XXXXXXXXXXX
X   R   XXXXXXXXXXX
X  w w  XXXXXXXXXXX
X  m m  XXXXXXXXXXX
X   m   XXXXXXXXXXX
X                 X
X                 X
XXX   XXXXXXXXXX  X
XXX   XXXXX       X
XXX   XXXXX       X
XXX   XXXXX  XXXXXX
XXX   XXXXX       X
XXX   XXXXX       X
XXX   XXXXXXXXXX  X
XXX   XXXXX       X
XXX   XXXXX       X
XXX   XXXXX  XXXXXX
XXX   XXXXX       X
XXX   XXXXX       X
XXX   XXXXXXXXXX  X
XXX   XXXXX       X
XXX   XXXXX   R   X
