XXXXXXXXXXXXXXXXXXXXXXXXXXXXXXXXXXXXX
X   w  m                            X
X    w  m                           X
X   w  m                            X
XXXXXXXXXX                 XXXXXXXXXX
XXXXXXXXXX                 XXXXXXXXXX
XXXXXXXXXX                 XXXXXXXXXX
X                                   X
X   R                           R   X
X                                   X
XXXXXXXXXXXXXXXXX   XXXXXXXXXXXXXXXXX
X                                   X
X                                   X
X                                   X
XXXXXXXXXXXXXXXXX   XXXXXXXXXXXXXXXXX
X                                   X
X                                   X
X                                   X
X                                   X
X                                   X
XXXXXXXXXXXXXXXXX   XXXXXXXXXXXXXXXXX
X                                   X
X                                   X
X                 R                 X
