XXXXXXXXXXXXXXXXXXXXXXXXXXXXXXX
X                             X
X    ww                       X
X                             X
XXXXXXXXXX               XXXXXX
XXXXXXXXXX               XXXXXX
XXXXXXXXXX     XXXXXXXXXXXXXXXX
X              X              X
X              X              X
X    RR        X      RRR     X
X              X              X
X              X              X
X                             X
X                             X
XXXXXXXXXXX         XXXXXXXXXXX
X                             X
X              R              X
X                             X
