xxxxxxxxxxxxxxxxxxxxxxxxxxxxxxxxxxxxx
x   w  m                            x
x    w  m                           x
x   w  m                            x
xxxxxxxxxx                 xxxxxxxxxx
xxxxxxxxxx                 xxxxxxxxxx
xxxxxxxxxx                 xxxxxxxxxx
x                                   x
x   R                           R   x
x                                   x
xxxxxxxxxxxxxxxxx   xxxxxxxxxxxxxxxxx
x                                   x
x                                   x
x                                   x
xxxxxxxxxxxxxxxxx   xxxxxxxxxxxxxxxxx
x                                   x
x                                   x
x                                   x
x                                   x
x                                   x
xxxxxxxxxxxxxxxxx   xxxxxxxxxxxxxxxxx
x                                   x
x                                   x
x                 R                 x